33333333333
3   333   3
3         3
3   3 3   3
33333 33333
3         3
3         3
3         3
33333333333