3333333333333333333333333
3                       3
3                       3
3333333333333333333333  3
3                       3
3                       3
3 33333333333333333333333
3                       3
333333333333 333333333333
3                       3
33333 3333333333333333333
3                       3
3                       3
3                       3
3                       3
3                       3
3                       3
3                       3
3                       3
3                       3
3                       3
3                       3
3                       3
3                       3
3333333333333333333333333
